13 11
  ###   ###  
 #   # #   # 
#  #. # .#  #
# $$$.#.$$* #
#  #.$*$.#  #
 # .  #  . # 
  ##.$*$.##  
   #     #   
    # $ #    
     #@#     
      #      