21 21
     ####            
     #  ########     
     #  .      #     
     #  ### $$ #     
     # $#  # .$#     
 #####  # . .#.######
 #  $.  #  # .    $ #
 # $.#.###$###  $   #
 # $ . #.   .#####.##
 #  # ## *$$ #   # # 
 # # . $ $@$ $ . # # 
 # #   # $$* ## #  # 
##.#####.   .# . $ # 
#   $  ###$###.#.$ # 
# $    . #  #  .$  # 
######.#. . #  ##### 
     #$. #  #$ #     
     # $$ ###  #     
     #      .  #     
     ########  #     
            ####     