10 7
##########
#        #
#  $$    #
#     #  #
#   @ .  #
#        #
##########