10 7
##########
#        #
#   $  @ #
#     #  #
#    .   #
#        #
##########