87 87
#######################################################################################
# . *  * . * * * * *  * $ * * * $ *  * * * * *   *  * $ * * * * *  * . * * * . *  * $ #
#$# # ## #$  #   # # ## #.  #  .# # ## #   #  .# # ## #.  #   # # ## #$  #  $# # ## #.#
#          #####          #####          #####          #####          #####          #
#*# #### #*#    *# #### #*#    *# #### #*#    *# #### #*#    *# #### #*#    *# #### #*#
# # #  #   ## #  # #  #   ## #  # #  #   ## #  # #  #   ## #  # #  #   ## #  # #  #   #
#   #  # #  *  #   #  # #  *  #   #  # #  *  #   #  # #  *  #   #  # #  *  #   #  # # #
#*# #### #*#   #*# #### #*#   #*# #### #*#   #*# #### #*#   #*# #### #*#   #*# #### #*#
#          #####          #####          #####          #####          #####          #
#.# ## # #.  #   # ## # #$  #   # ## # #$  #  .# ## # #   #  $# ## # #   #  $# ## # #.#
# $ *  * $ * * * * *  * . * * * * *  * . * * * $ *  * * * * * . *  * * * * * . *  * $ #
#* #  ### *#####* ###### *#####* ###### *#####* ###### *#####* ###### *#####* ## ### *#
#  # #  #  #   #  #    #  #   #  #    #  #   #  #    #  #   #  #    #  #   #  # *# #  #
#*##    ##*#   #*## ## ##*#   #*## ## ##*#   #*## ## ##*#   #*## ## ##*#   #*##    ##*#
#  # #* #  #   #  #    #  #   #  #    #  #   #  #    #  #   #  #    #  #   #  #  # #  #
#* ### ## *#####* ###### *#####* ###### *#####* ###### *#####* ###### *#####* ###  # *#
# $ *  *   * * *   *  *   * * * . *  * * * * * $ *  * . * * *   *  * * * * *   *  *   #
#.# # ## #*  #  *# # ## #*  #  $# # ## #   #  .# # ## #$  #  *# # ## #   #  *# # ## #*#
#          #####          #####          #####          #####          #####          #
#*# #### #*#   #*# #### #*#   #*# #### #*#   #*# #### #*#   #*# #### #*#   #*# #### #*#
# # #  #   # # # # #  #   #  *  # #  #   #  *  # #  #   #  *  # #  #   #  *  # #  #   #
#   #  # # # # #   #  # #  # ##   #  # #  # ##   #  # #  # ##   #  # #  # ##   #  # # #
#*# #### #*#   #*# #### #*    #*# #### #*    #*# #### #*    #*# #### #*    #*# #### #*#
#          #####          #####          #####          #####          #####          #
#.# ## # #*  #   # ## # #*  #  $# ## # #$  #  $# ## # #.  #   # ## # #   #  .# ## # #$#
# $ *  *   * * * * *  *   * * *   *  * . * * * . *  * $ * * * * *  * * * * * $ *  * . #
#* #  ### *#####* ## ### *#####* ###### *#####* ###### *#####* ###### *#####* ###### *#
#  # #  #  #   #  # *# #  #   #  #    #  #   #  #    #  #   #  #    #  #   #  #    #  #
#*##    ##*#   #*##    ##*#   #*## ## ##*#   #*## ## ##*#   #*## ## ##*#   #*## ## ##*#
#  # #* #  #   #  #  # #  #   #  #    #  #   #  #    #  #   #  #    #  #   #  #    #  #
#* ### ## *#####* ###  # *#####* ###### *#####* ###### *#####* ###### *#####* ###### *#
# . *  * $ * * *   *  * . * * * * *  * $ * * * . *  *   * * * $ *  * $ * * *   *  * . #
#$# # ## #.  #  *# # ## #$  #   # # ## #.  #  $# # ## #*  #  .# # ## #.  #  *# # ## #$#
#          #####          #####          #####          #####          #####          #
#*# #### #*#   #*# #### #*#    *# #### #*#    *# #### #*#    *# #### #*#    *# #### #*#
# # #  #   # # # # #  #   ## #  # #  #   ## #  # #  #   ## #  # #  #   ## #  # #  #   #
#   #  # # # # #   #  # #  *  #   #  # #  *  #   #  # #  *  #   #  # #  *  #   #  # # #
#*# #### #*#   #*# #### #*#   #*# #### #*#   #*# #### #*#   #*# #### #*#   #*# #### #*#
#          #####          #####          #####          #####          #####          #
#$# ## # #$  #   # ## # #*  #  .# ## # #.  #  $# ## # #$  #  .# ## # #*  #  .# ## # #*#
# . *  * . * * * * *  *   * * * $ *  * $ * * * . *  * . * * * $ *  *   * * * $ *  *   #
#* #  ### *#####* ###### *#####* ###### *#####* ###### *#####* ###### *#####* ## ### *#
#  # #  #  #   #  #    #  #   #  #    #  #   #  #    #  #   #  #    #  #   #  # *# #  #
#*##    ##*#   #*## ## ##*#   #*## ## ##*#   #*## ## ##*#   #*## ## ##*#   #*##    ##*#
#  # #* #  #   #  #    #  #   #  #    #  #   #  #    #  #   #  #    #  #   #  #  # #  #
#* ### ## *#####* ###### *#####* ###### *#####* ###### *#####* ###### *#####* ###  # *#
#   *  * $ * * *   *  * $ * * * . *  * . * * * $ *  * $ * * *   *  * * * * * . *  * . #
#*# # ## #.  #  *# # ## #.  #  $# # ## #$  #  .# # ## #.  #  *# # ## #   #  $# # ## #$#
#          #####          #####          #####          #####          #####          #
#*# #### #*#   #*# #### #*#   #*# #### #*#   #*# #### #*#   #*# #### #*#   #*# #### #*#
# # #  #   # # # # #  #   #  *  # #  #   #  *  # #  #   #  *  # #  #   #  *  # #  # # #
#   #  # # # # #   #  # #  # ##   #  # #  # ##   #  # #  # ##   #  # #  # ##   #  #   #
#*# #### #*#   #*# #### #*    #*# #### #*    #*# #### #*    #*# #### #*    #*# #### #*#
#          #####          #####          #####          #####          #####          #
#$# ## # #*  #  .# ## # #.  #  *# ## # #$  #  .# ## # #   #  $# ## # #*  #  .# ## # #$#
# . *  *   * * * $ *  * $ * * *   *  * . * * * $ *  * * * * * . *  *   * * * $ *  * . #
#* #  ### *#####* ## ### *#####* ###### *#####* ###### *#####* ###### *#####* ###### *#
#  # #  #  #   #  # *# #  #   #  #    #  #   #  #    #  #   #  #    #  #   #  #    #  #
#*##    ##*#   #*##    ##*#   #*## ## ##*#   #*## ## ##*#   #*## ## ##*#   #*## ## ##*#
#  # #* #  #   #  #  # #  #   #  #    #  #   #  #    #  #   #  #    #  #   #  #    #  #
#* ### ## *#####* ###  # *#####* ###### *#####* ###### *#####* ###### *#####* ###### *#
# . *  * $ * * * * *  * * * * * $ *  * * * * * . *  * . * * *   *  * * * * *   *  * $ #
#$# # ## #.  #   # # ## #   #  .# # ## #   #  $# # ## #$  #  *# # ## #   #  *# # ## #.#
#          #####          #####          #####          #####          #####          #
#*# #### #*#   #*# #### #*#    *# #### #*#    *# #### #*#    *# #### #*#    *# #### #*#
# # #  #   # # # # #  #   ## #  # #  #   ## #  # #  #   ## #  # #  #   ## #  # #  #   #
#   #  # # # # #   #  # #  *  #   #  # #  *  #   #  # #  *  #   #  # #  *  #   #  # # #
#*# #### #*#   #*# #### #*#   #*# #### #*#   #*# #### #*#   #*# #### #*#   #*# #### #*#
#          #####          #####          #####          #####          #####          #
#*# ## # #*  #   # ## # #*  #   # ## # #*  #   # ## # #$  #  *# ## # #*  #  *# ## # #.#
#   *  *   * * * * *  *   * * * * *  *   * * * * *  * . * * *   *  *   * * *   *  * $ #
#* #  ### *#####* ###### *#####* ###### *#####* ###### *#####* ###### *#####* ## ### *#
#  # #  #  #   #  #    #  #   #  #    #  #   #  #    #  #   #  #    #  #   #  # *# #  #
#*##    ##*#   #*## ## ##*#   #*## ## ##*#   #*## ## ##*#   #*## ## ##*#   #*##    ##*#
#  # #* #  #   #  #    #  #   #  #    #  #   #  #    #  #   #  #    #  #   #  #  # #  #
#* ### ## *#####* ###### *#####* ###### *#####* ###### *#####* ###### *#####* ###  # *#
# $ *  * . * * * * *  * * * * * . *  * $ * * * . *  * * * * * . *  * * * * * $ *  * $ #
#.# # ## #$  #   # # ## #   #  $# # ## #.  #  $# # ## #   #  $# # ## #   #  .# # ## #.#
#          #####          #####          #####          #####          #####          #
#*# #### #*#   #*# #### #*#   #*# #### #*#   #*# #### #*#   #*# #### #*#   #*# #### #*#
# # #  #   #  *  # #  #   #  *  # #  #   #  *  # #  #   #  *  # #  #   #  *  # #  #   #
#   #  # #  # ##   #  # #  # ##   #  # #  # ##   #  # #  # ##   #  # #  # ##   #  # # #
#*# #### #*    #*# #### #*    #*# #### #*    #*# #### #*    #*# #### #*    #*# #### #*#
#          #####          #####          #####          #####          #####     @    #
#.# ## # #$  #  $# ## # #$  #  .# ## # #.  #   # ## # #.  #  .# ## # #   #  $# ## # #$#
# $ *  * . * * * . *  * . * * * $ *  * $ * * * * *  * $ * * * $ *  * * * * * . *  * . #
#######################################################################################