31 50
            #######            
            #     #            
            #  $  #            
           #  $ $  #           
          #  $   $  #          
         #  $     $  #         
       ##  $       $  ##       
       #  $         $  #       
       #.*.####.####.*.#       
       #***************#       
       #...............#       
       #               #       
       ### #############       
         # .*. # .*. #         
        #  **. # .**  #        
       #  $.*. # .*.$  #       
      #  $ #*. # .*# $  #      
     #  $  #*. # .*#  $  #     
    #  $   #*. # .*#   $  #    
 ###  $    #*. # .*#    $  ### 
 #   $     #*. # .*#     $   # 
 #  $      .*.@* .*.      $  # 
 #   $     #*. # .*#     $   # 
 ###  $    #*. # .*#    $  ### 
    #  $   #*. # .*#   $  #    
     #  $  #*. # .*#  $  #     
      #  $ #*. # .*# $  #      
       #  $.*. # .*.$  #       
        #  **. # .**  #        
         # .*. # .*. #         
#################### ##########
#                             #
#.............................#
#*****************************#
#.*.###########.###########.*.#
#  $                       $  #
##  $                     $  ##
  #  $  $ $ $ $ $ $ $ $  $  #  
   #  $  $ $ $ $ $ $ $  $  #   
    #  $  $ $ $ $ $ $  $  #    
     #  $  $ $ $ $ $  $  #     
      #  $  $ $ $ $  $  #      
       #  $  $ $ $  $  #       
        #  $  $ $  $  #        
         #  $  $  $  #         
          #  $   $  #          
           #  $ $  #           
            #  $  #            
            #     #            
            #######            