8 11
 ####   
 #  ####
 #  #  #
 #..*..#
 #  # .#
 #  #$##
##   $ #
# $#$$ #
#     ##
#  #  # 
####### 