19 11
    #####          
    #   #          
    #$   #         
  ###  $##         
  #  $ $ #         
### # ## #   ######
#   # ## #####  ..#
# $ $           ..#
##### ### #@##  ..#
    #     #########
    #######         