14 10
############  
#..  #     ###
#..  # $  $  #
#..  #$####  #
#..    @ ##  #
#..  # #  $ ##
###### ##$ $ #
  # $  $ $ $ #
  #    #     #
  ############