11 10
  ######## 
 ##  . . # 
 # *$# # # 
 #.  #$# ##
##* #  #  #
#   # *   #
# $#@ .#  #
#     $ ###
##  #   #  
 ########  