15 11
#####          
# . ##     ### 
#$.$ #######.##
#.  ..*  #.$  #
# .# $ # #  $.#
# ###$ #... # #
#. #  # .##$$ #
#.$$$ # ## $  #
##   $ #@$ $  #
 #     * $  . #
 ##############