8 8
########
#@     #
# #$##.#
# # .$.#
# # $$ #
# $ .#.#
###    #
  ######