11 10
###### ####
#    ###  #
# *     * #
## #***#  #
 #  *+*  ##
## #*$*# ##
#  # # #  #
#         #
#  ########
####       