17 12
     #######     
     #  @  #     
     # ### ##    
#### # # #  #####
#  ### # # .    #
# .    # # * $$ #
# * $$ # # *## ##
# *## ## # *   # 
# .   #  # *## # 
#  ####  # .   # 
####     #  #### 
         ####    