10 7
##########
#        #
#   @    #
#     #  #
#    $.  #
#        #
##########
