9 10
######## 
#..*.*.##
#### . .#
###  * ##
#. $$$ # 
##    $##
 ####   #
  #@$$$ #
  #   ###
  #####  