 #######
 #  #. #
 #  *..#
 #  #..#
 #$ #$##
##   $@#
#  #$$ #
#     ##
#  #  # 
####### 