33 31
  #############################  
  #                           #  
### .$.# $ $ $ $ $ $ $ $ #.$. #  
#   $ $.#.$.$.$.$.$.$.$.#.$ $ #  
# ##.$ $.#.$.$.$.$.$.$.#.$ $.####
# $.#.$ $.#.$.$.$.$.$.#.$ $.#.$ #
#  $.#.$ $.#.$.$.$.$.#.$ $.#.$  #
# $.$.#.$ $.#.$.$.$.#.$ $.#.$.$ #
#  $.$.#.$ $.#.$.$.#.$ $.#.$.$  #
# $.$.$.#.$ $.#.$.#.$ $.#.$.$.$ #
#  $.$.$.#.$ $.#.#.$ $.#.$.$.$  #
# $.$.$.$.#.$ $ # $ $.#.$.$.$.$ #
#  $.$.$.$.#.$. # .$.#.$.$.$.$  #
# $.$.$.$.$.# $ # $ #.$.$.$.$.$ #
#  $.$.$.$. # . # . # .$.$.$.$  #
# $.$.$.$.$.### @ ###.$.$.$.$.$ #
#  $.$.$.$. # . # . # .$.$.$.$  #
# $.$.$.$.$.# $ # $ #.$.$.$.$.$ #
#  $.$.$.$.#.$. # .$.#.$.$.$.$  #
# $.$.$.$.#.$ $ # $ $.#.$.$.$.$ #
#  $.$.$.#.$ $.#.#.$ $.#.$.$.$  #
# $.$.$.#.$ $.#.$.#.$ $.#.$.$.$ #
#  $.$.#.$ $.#.$.$.#.$ $.#.$.$  #
# $.$.#.$ $.#.$.$.$.#.$ $.#.$.$ #
#  $.#.$ $.#.$.$.$.$.#.$ $.#.$  #
# $.#.$ $.#.$.$.$.$.$.#.$ $.#.$ #
####.$ $.#.$.$.$.$.$.$.#.$ $.## #
  # $ $.#.$.$.$.$.$.$.$.#.$ $   #
  # .$.# $ $ $ $ $ $ $ $ #.$. ###
  #                           #  
  #############################  