15 15
        ###### 
#### #### .  # 
#  ###  # $  # 
#      . ## ## 
#.$###$.$ # #  
#  #  $.  # ## 
### $ $.$$$  # 
 # ....*.... # 
 #  $$$.$ $ ###
 ## #  .$  #  #
  # # $.$###$.#
 ## ## .      #
 #  $ #@ ###  #
 #  . #### ####
 ######        