8 11
  ##### 
  #   # 
  #   # 
###$ $# 
#@$   # 
##$$$ ##
 # $   #
 #.*.# #
##.#.# #
#.. .* #
########