19 14
           ########
           #  ....#
############  ....#
#    #  $ $   ....#
# $$$#$  $ #  ....#
#  $     $ #  ....#
# $$ #$ $ $########
#  $ #     #       
## #########       
#    #    ##       
#     $   ##       
#  $$#$$  @#       
#    #    ##       
###########        