13 21
#############
####   ##   #
####$.$.* # #
## . .  #.  #
#  # *. #$###
# ## #$ #.###
#  $$#. # ###
## $ #$ # ###
## $@#. # ###
## $ #$ # ###
##.## *  .###
## ##   # ###
## #####    #
## #####    #
## ######## #
## ####   # #
## #### $.  #
## ##### ####
##        ###
#######   ###
#############