12 9
    ######  
    #. *@#  
   ##.*$##  
  ## $*  #  
  #  $..*## 
###$  #   ##
#   $##.#$ #
#   .      #
############