9 10
   ######
   #  *.#
####*.$ #
#.*  $ $#
#  .#*  #
##.  $ ##
##.**# # 
#  * $$##
#   . $@#
#########