17 17
    #########    
    #       #    
  ###$#$ $#$###  
  # . . . . . #  
###$#$#$ $#$#$###
# . . . . . . . #
# #$#$#$#$#$#$# #
# . . .   . . . #
###$#$##@##$#$###
# . . .   . . . #
# #$#$#$#$#$#$# #
# . . . . . . . #
###$#$#$ $#$#$###
  # . . . . . #  
  ###$#$ $#$###  
    #       #    
    #########    