11 10
######     
#... ######
###  ##   #
 # $.$.$  #
 #@* * .###
 # $ $ $  #
 # # ##   #
 #.#$$. ###
 #    ###  
 ######    